######E#######
#............#
#............#
#...FFFFFF...#
#..FFFFFFFF..#
#..FF....FF..#
E..FF..P.FF..E
#..FF....FF..#
#..FFFFFFFF..#
#...FFFFFF...#
#............#
#............#
######E#######
