######E#######
#.....FF.....#
#....FFFF....#
#...FFFFFF...#
#.....FF.....#
E.....FF.....#
#......P.....#
#.....FF.....#
#.....FF.....E
#...FFFFFF...#
#....FFFF....#
#.....FF.....#
#####E########
